****************************************
********************             *******
******************** *********** *******
******************** *********** *******
***********          **     **** *******
*********** ***** ********* **** *******
*********** ***** ********* **** *******
*********** ***** *** *****      *******
*********** ***** *** ***** ************
*********** ***** *** ***** ************
*********** ***** ***       ************
****        *************** ************
**** ****** *************** ************
**** ****** ****     -*     ************
**** ****** **** ****** ***           **
*    ****** **** ********** ********* **
* ********* ****            ********* **
* ********* ************************* **
* *********              ***          **
*+**************************************