****************************************
********                          ******
******** ************************ ******
******** *****              ***** ******
******** ***** ************ ***** ******
******** ***** ************ ***** ******
******** ***** ************ ***** ******
******** ***** ************ ***** ******
******** ***** ************ ***** ******
******** ***** ************ ***** ******
******** ***** *******-**** ***** ******
**       ***** ******* **** ***** ******
******** ***** ******* **** ***** ******
******** ***** ******* **** ***** ******
**       ***** *******         ** ******
******** ***** ****************** ******
******** ***** ****************** ******
******** *****                    ******
******** *******************************
********+*******************************