****************************************
********************             *******
******************** *********** *******
******************** *********** *******
***********          **     **** *******
*********** ***** ********* **** *******
*********** ***** ********* **** *******
*********** ***** ***-*****      *******
*********** ***** *** ***** ************
*********** ***** *** ***** ************
*********** ***** ***       ************
****        *************** ************
**** ****** *************** ************
**** ****** *************** ************
**** ****** ****************************
*    ****** ****************************
* ********* ****************************
* ********* ****************************
* *********              ***************
*+**************************************